%%%%%%%%%%%%%%%
%             %
%     ...     %
%     .%.     %
%  ....%....  %
%  .%%%%%%%.  %
%  ....%....  %
%     .%.     %
%   P ...     %
%             %
%%%%%%%%%%%%%%%
