%%%%%%%%%%%%%%%
%......%.....%%
%.... .%. ...%%
%%%%.P.%. .%%%%
%...  .%. .%%%%
%..   .%...%%%%
%%........%%%%%
%%..%.....%%%%%
%%%%%%%%%%%%%%%
